                        
                                 LEVEL 2

                _______________________________________________
                | 8    9    5  |  1    6    4  |  7    2    3 |
                |          ___ |               |              |
                | 1    6  |___||  3    7    5  |  8    4    9 |
                |              |               |              |   
                | 7    4    3  |  8    9    2  |  1    5    6 |
                |--------------|---------------|--------------|
                | 4    3    8  |  7    2    1  |  6    9    5 |
                |          ___ |               |              |
                | 9    2  |___||  5    4    6  |  3    8    1 |
                |              |               |              |      GUESS WHICH NUMBERS HAVE TO 
                | 6    5    1  |  9    3    8  |  4    7    2 |        USE IN THE BLANKS
                |--------------|---------------|--------------|
                | 5    8    6  |  2    1    7  |  9    3    4 |
                |          ___ |           ___ |              |
                | 2    1  |___||  4    8  |___||  5    6    7 |
                |              |               |              |
                | 3    7    4  |  6    5    9  |  3    1    8 |
                |______________|_______________|______________|