                        
                                 LEVEL 3

                _______________________________________________
                | 5    6  |___||  1    2    4  |  8    7    9 |
                |              |               |              |
                | 2    7    4  |  3    8    9  |  1    6    5 |
                |          ___ |               |              |   
                | 8    9  |___||  5    7    6  |  3    4    2 |
                |--------------|---------------|--------------|
                | 4    1    7  |  9    3    8  |  5  |___|  6 |
                |              |               |              |
                | 6    3    8  |  2    4    6  |  9    1    7 |
                |          ___ |               |      ___     |        GUESS WHICH NUMBERS HAVE TO 
                | 9    5  |___||  6    1    7  |  4  |___|  8 |        USE IN THE BLANKS !!!!!!!
                |--------------|---------------|--------------|
                | 7    2    5  |  4    9    3  |  6    8    1 |
                |              |               |              |
                | 1    4    9  |  8    6    2  |  7    5    3 |
                |          ___ |               |              |
                | 3    8  |___||  7    5    1  |  2    9    4 |
                |______________|_______________|______________|
                                                         
