                              
                                 LEVEL 1

                _______________________________________________
                | 5    1    3  |  6    9    7  |  8    2    4 |
                |              |               |              |
                | 8    9    2  |  4    1    3  |  6    5    7 |
                |          ___ |               |              |   
                | 6    4  |___||  5    2    8  |  9    1    3 |
                |______________|_______________|______________|
                | 7    8    4  |  2    6    9  |  1    3    5 |
                |              |      ___      |              |
                | 3    2    1  |  8  |___|  4  |  7    6    9 |
                |              |               |              |      GUESS WHICH NUMBERS HAVE TO
                | 9    6    5  |  7    3    1  |  4    8    2 |      
                |______________|_______________|______________|      USE IN THE BLANKS ??????
                | 2    5    9  |  1    4    6  |  3    7    8 |
                |              |      ___      |              |
                | 1    3    8  |  9  |___|  5  |  2    4    6 |
                |              |               |              |
                | 4    7    6  |  3    8    2  |  5    9    1 |
                |______________|_______________|______________|

                                                         
